%%%%%%%%%%%%%%%%%
%............%.G%
%...G........o..%
%...............%
%%P........%%...%
%...............%
%...G...........%
%............o..%
%%%%%%%%%%%%%%%%%
